+---+---+---+---+---+
| A | D   1   1   F |
+   +   +   +---+---+
| 1 | 2 | 1   E   1 |
+   +   +---+---+   +
| 3   1 | 1   2   1 |
+---+---+---+   +---+
| C   1   1   4   G |
+   +   +   +---+   +
| B   1   6 | H   1 |
+---+---+---+---+---+
